9 8 6 7 9 9 5 1 1 4 9 9 8 6 7 9
9 8 6 7 9 3 5 1 1 4 3 9 8 6 7 9
9 8 6 7 9 9 5 1 1 4 9 9 8 6 7 3
9 8 6 7 9 3 5 1 1 4 9 9 8 6 7 9
3 8 6 7 9 9 5 1 1 4 9 3 8 6 7 9
9 8 6 7 3 9 5 1 1 4 9 9 8 6 7 9
3 8 6 7 9 9 5 1 1 4 9 3 8 6 7 3
9 8 6 7 9 9 5 1 1 4 9 9 8 6 7 9 
9 8 6 7 9 3 5 1 1 4 3 9 8 6 7 9 
9 8 6 7 9 9 5 1 1 4 9 9 8 6 7 9 
9 8 6 7 9 9 5 1 1 4 9 9 8 6 7 9 
3 8 6 7 3 9 5 1 1 4 9 3 8 6 7 9 